20 20 20 20 20 20 20 20 20 20 20 20 20 20 20 20 20 20 20 20 20 20 20 20 20 20 20 20 20 20 20 20 20 20 20 20 20 20 20 20 20 20 20 20 20 20 20 20 20 20 20 20 20 20 20 20 20 20 20 20 20 20 20 21 21 21 21 21 21 20 20 20 20 20 20 20 20 20 20 20 20 20 20 20 20 20 20 20 20 20 20 20 20 20 20 20 20 20 20 20 20 20 20 20 20 20 20 20 20 20 20 20 21 21 21 21 21 21 21 21 
22 21 20 20 20 20 20 20 20 20 20 20 20 20 20 20 20 20 20 20 20 20 20 20 20 20 20 20 20 20 20 20 20 20 20 20 20 20 20 20 20 20 20 20 20 20 20 20 20 20 20 20 20 20 20 20 20 20 20 20 20 21 21 21 21 21 21 21 21 21 21 21 21 21 20 20 20 20 20 20 20 20 20 20 20 20 20 20 20 20 20 20 20 20 20 20 20 20 20 20 20 20 20 20 20 20 20 20 20 20 21 21 21 21 21 21 21 21 21 21 
21 20 20 20 20 20 20 20 20 20 20 20 20 20 20 20 20 20 20 20 20 20 20 20 20 20 20 20 20 20 20 20 20 20 20 20 20 20 20 20 20 20 20 20 20 20 20 20 20 20 20 20 20 20 20 20 20 20 20 20 20 21 21 21 21 21 21 22 21 21 21 21 21 21 21 21 21 20 20 20 20 20 20 20 20 20 20 20 20 20 20 20 20 20 20 20 20 20 20 20 20 20 20 20 20 20 20 20 20 20 21 21 21 21 21 21 21 21 21 21 
20 20 20 20 20 20 20 20 20 20 20 20 20 20 20 20 20 20 20 20 20 20 20 20 20 20 20 20 20 20 20 20 20 20 20 20 20 20 20 20 20 20 20 20 20 20 20 20 20 20 20 20 20 20 20 20 20 20 20 21 21 21 22 22 22 22 22 22 22 22 22 21 21 21 21 20 20 20 20 20 20 20 20 20 20 20 20 20 20 20 20 20 20 20 20 20 20 20 20 20 20 20 20 20 20 20 20 20 20 20 20 21 21 21 21 21 21 21 21 21 
20 20 21 20 20 20 20 20 20 20 20 20 20 20 20 20 20 20 20 20 20 20 20 20 20 20 21 21 20 20 21 21 20 20 20 20 20 20 20 20 20 20 20 20 20 20 20 20 20 20 20 20 20 20 20 20 20 20 21 21 21 22 22 22 23 23 24 24 23 22 22 22 21 21 21 21 21 21 20 20 20 20 20 20 20 20 20 20 20 20 20 20 20 20 20 20 20 20 20 20 20 20 20 20 20 20 20 20 21 21 20 21 21 21 21 21 21 21 21 21 
20 20 22 21 20 20 20 20 20 20 20 20 20 20 20 20 20 20 20 20 20 20 20 21 21 21 21 21 21 21 21 21 21 21 21 20 20 20 20 20 20 20 20 20 20 20 20 20 20 20 20 20 20 20 20 20 21 21 21 21 21 22 23 24 24 25 26 26 26 25 25 24 23 22 22 21 21 21 20 20 20 20 20 20 20 20 20 20 20 20 20 20 20 20 20 20 20 20 20 20 20 20 20 20 20 20 21 21 21 21 21 21 21 21 21 21 21 21 21 21 
20 25 25 22 21 21 21 21 21 21 21 20 20 20 20 20 20 20 20 20 20 20 20 21 21 21 22 22 22 22 22 22 22 21 21 21 20 20 20 20 20 20 20 20 20 20 20 20 20 20 20 20 20 20 20 20 21 21 21 22 24 24 25 26 26 27 28 29 29 28 27 27 25 24 24 23 22 21 21 21 20 20 20 20 20 20 20 20 20 20 20 20 20 20 20 20 20 20 20 20 20 20 20 21 21 21 21 21 21 21 21 21 21 21 21 21 21 21 21 21 
21 27 27 23 21 21 21 21 21 21 21 21 21 20 20 20 20 20 20 20 20 20 20 21 21 21 21 22 22 22 22 22 22 22 21 21 21 20 20 20 20 20 20 20 20 20 20 20 20 20 20 20 20 20 20 20 20 21 21 22 23 25 25 26 27 27 29 29 29 30 29 27 27 26 24 24 22 21 21 21 21 21 21 20 20 20 20 20 20 20 20 20 20 20 20 20 20 20 20 20 20 20 21 21 21 21 21 21 21 21 21 21 21 21 21 21 21 21 21 21 
21 21 20 20 21 21 21 21 21 21 21 21 20 20 20 20 20 20 20 20 20 20 20 20 21 21 21 22 22 22 22 22 22 22 21 21 21 20 20 20 20 20 20 20 20 20 20 20 20 20 20 20 20 20 20 20 20 21 22 22 23 26 26 27 28 28 30 30 31 31 30 29 29 27 25 25 23 22 21 21 21 21 21 20 20 20 20 20 20 20 20 20 20 20 20 20 20 20 20 20 20 20 20 21 21 21 21 21 21 21 21 21 21 21 21 21 21 21 21 21 
21 20 20 21 21 20 21 21 21 21 21 21 20 20 20 20 20 20 20 20 20 20 20 20 21 21 21 21 22 22 22 22 22 22 21 21 21 21 20 20 20 20 20 20 20 20 20 20 20 20 20 20 20 20 20 20 20 21 22 22 24 27 29 29 30 31 31 31 32 32 31 30 28 28 26 24 24 22 21 21 21 21 21 21 20 20 20 20 20 20 20 20 20 20 20 20 20 20 20 20 21 21 21 21 21 21 21 21 21 21 21 21 21 21 21 21 21 21 21 21 
20 20 20 20 20 20 21 21 21 21 20 20 20 20 20 20 20 20 20 20 20 20 20 20 20 21 21 21 21 21 21 21 21 21 21 21 20 20 20 20 20 20 20 20 20 20 20 20 20 20 20 20 20 20 20 20 20 21 22 24 24 27 29 29 30 31 31 32 32 32 32 31 29 29 27 25 25 22 21 21 21 21 21 21 20 20 20 20 20 20 20 20 20 20 20 20 20 20 20 20 20 21 21 21 21 21 21 21 21 21 21 21 21 21 21 21 21 21 21 21 
20 20 20 20 20 20 20 20 20 21 20 20 20 20 20 20 20 20 20 20 20 20 20 20 20 20 21 21 21 21 21 21 21 21 21 21 20 20 20 20 20 20 20 20 20 20 20 20 20 20 20 20 20 20 20 20 21 21 22 24 24 26 29 29 30 31 32 32 32 32 32 31 30 30 28 26 23 23 21 21 21 21 21 21 20 20 20 20 20 20 20 20 20 20 20 20 20 20 20 21 21 21 21 21 21 21 21 21 21 21 21 21 21 21 21 21 21 21 21 21 
21 26 26 21 20 20 20 20 20 20 20 20 20 20 20 20 20 20 20 20 20 20 20 20 20 20 20 20 20 20 21 21 21 21 21 21 21 21 21 21 21 21 20 20 20 20 20 20 20 20 20 20 20 20 20 20 21 21 21 23 26 26 29 30 30 31 32 32 32 32 31 31 31 28 28 26 23 23 21 21 21 21 20 20 20 20 20 20 20 20 20 20 20 20 20 21 21 21 21 21 21 21 21 21 21 21 21 21 21 21 21 21 21 21 21 21 21 21 21 21 
21 29 29 22 21 21 20 20 20 20 20 20 20 21 20 20 20 20 20 20 20 20 20 20 21 21 21 21 21 21 20 21 21 21 21 21 22 22 22 21 21 21 21 20 20 20 20 20 20 20 20 20 20 20 20 20 20 21 21 22 25 25 28 30 30 31 32 32 32 31 31 31 31 30 30 28 25 22 22 21 21 21 20 20 20 20 20 20 20 20 20 20 20 20 20 21 21 21 21 21 21 21 21 21 21 21 21 21 21 21 21 21 21 21 21 21 21 21 21 21 
21 29 22 22 21 20 20 20 20 20 20 20 20 21 20 20 20 20 20 20 20 21 21 21 21 21 21 21 21 21 20 21 21 21 22 22 23 23 23 23 23 23 23 22 21 21 21 20 20 20 20 20 20 20 20 20 20 21 21 22 24 27 27 29 31 31 32 32 32 32 31 31 31 30 28 28 25 22 22 21 21 21 20 21 20 20 20 20 20 20 20 20 20 20 21 21 21 21 21 21 21 21 21 21 21 21 21 21 21 21 21 21 21 21 21 21 21 21 21 21 
21 21 22 22 21 21 21 20 20 20 20 20 21 21 21 20 20 20 20 20 20 21 21 21 21 21 21 21 21 21 21 21 21 21 22 23 23 24 24 24 24 23 23 23 22 21 21 21 21 21 20 20 20 20 20 20 20 21 22 22 23 26 26 28 30 30 32 32 32 32 32 31 31 31 29 29 26 23 21 21 21 21 21 21 20 20 20 20 20 20 20 20 20 20 21 21 21 21 21 21 21 21 21 21 21 21 21 21 21 21 21 21 21 21 21 21 21 21 21 21 
21 21 22 22 20 20 20 20 20 20 20 20 20 20 20 20 20 20 20 20 20 20 21 21 21 21 21 21 21 21 21 21 21 21 22 23 23 24 24 25 25 24 24 24 22 21 21 21 21 21 21 20 20 20 20 20 20 20 21 21 23 25 27 27 29 31 31 32 32 32 32 32 32 31 30 27 27 24 22 22 21 21 21 21 20 20 20 20 20 20 21 21 21 21 21 21 21 21 21 21 21 21 21 21 21 21 21 21 21 21 21 21 21 21 21 21 21 21 21 21 
21 21 21 24 24 25 25 25 21 20 20 20 20 20 20 20 20 20 20 20 20 20 20 21 21 21 21 21 21 21 21 21 21 21 22 23 24 24 25 25 25 25 24 24 23 22 21 21 21 21 21 21 21 21 21 21 21 21 21 23 23 24 27 27 29 30 30 32 32 32 32 32 31 31 30 27 27 24 22 21 21 21 21 21 20 21 21 20 20 20 21 21 21 21 21 21 21 21 21 21 21 21 21 21 21 21 21 21 21 21 21 21 21 21 21 21 21 21 21 21 
21 21 22 21 21 20 20 20 20 20 20 20 21 21 21 21 21 21 21 21 22 22 22 24 24 25 26 26 26 26 26 26 25 25 25 25 26 26 27 28 28 28 27 25 25 23 22 22 21 21 21 21 21 21 21 22 21 21 21 21 21 22 24 26 26 29 31 31 32 32 32 32 32 31 31 28 25 25 23 21 21 21 21 20 20 21 21 21 20 21 21 21 21 21 21 21 21 21 21 21 21 21 21 21 21 21 21 21 21 21 21 21 21 21 21 21 21 21 21 21 
21 27 27 27 23 23 22 22 22 22 22 22 22 22 23 23 24 26 26 27 27 27 27 26 26 26 25 24 24 23 22 22 21 21 21 21 23 25 25 26 26 26 26 25 23 23 22 21 21 21 21 21 21 21 21 21 21 21 21 21 21 21 23 25 25 27 30 32 32 32 32 32 32 31 31 28 26 23 23 22 21 21 21 21 21 20 21 21 21 21 21 21 21 21 21 21 21 21 21 21 21 21 21 21 21 21 21 21 21 21 21 21 21 21 21 21 21 21 21 21 
21 29 29 26 24 25 25 26 27 27 27 27 27 26 24 23 23 23 23 23 24 25 25 25 26 25 25 25 25 25 26 26 26 26 27 27 27 28 28 28 27 27 27 25 23 23 22 21 21 21 21 21 21 21 21 21 21 21 21 21 21 23 23 24 26 26 29 31 31 32 32 32 32 31 29 29 26 23 23 22 21 21 21 21 21 21 21 21 21 21 21 21 21 21 21 21 21 21 21 21 21 21 21 21 21 21 21 21 21 21 21 21 21 21 21 21 21 21 21 21 
21 22 25 25 24 23 23 21 21 23 23 24 24 24 22 21 21 20 20 20 20 20 20 20 20 20 20 20 20 20 21 21 22 22 23 25 25 27 27 27 27 27 25 25 22 21 21 21 21 21 21 21 21 21 21 21 21 21 21 21 21 22 22 24 26 29 29 31 32 32 32 32 32 30 29 26 26 23 22 22 21 21 21 21 21 21 21 21 21 21 21 21 21 21 21 21 21 21 21 21 21 21 21 21 21 21 21 21 21 21 21 21 21 21 21 21 21 21 21 21 
21 21 21 20 20 21 21 21 20 20 20 20 20 20 20 20 20 20 20 20 20 20 20 20 20 20 20 20 20 21 21 21 21 21 22 24 24 26 27 28 28 27 25 25 22 21 21 21 21 21 21 21 21 21 21 21 21 21 21 21 21 22 24 24 25 28 28 31 32 32 32 32 31 31 30 27 27 24 22 22 21 21 21 21 21 21 21 21 21 21 21 21 21 21 21 21 21 21 21 21 21 21 21 21 21 21 21 21 21 21 21 21 21 21 21 21 21 21 21 21 
21 21 21 20 20 22 21 21 20 20 20 20 20 20 20 20 20 20 20 20 20 20 20 20 20 21 21 21 21 21 21 21 22 24 24 25 27 27 28 28 28 27 24 22 22 21 21 21 21 20 20 21 21 21 21 21 21 21 21 21 21 22 23 23 25 28 30 30 32 32 32 32 32 32 30 28 28 25 22 21 21 21 21 21 21 21 21 21 21 21 21 21 21 21 21 21 21 21 21 21 21 21 21 21 21 21 21 21 21 21 21 21 21 21 21 21 21 21 21 21 
21 21 22 20 21 21 21 21 21 20 20 20 20 20 20 20 20 20 20 20 20 20 20 21 21 21 21 21 21 21 21 21 22 24 24 25 27 27 28 28 27 27 25 23 23 21 21 21 21 21 21 21 21 21 21 21 22 22 22 22 22 22 24 25 25 27 29 29 31 32 32 32 32 31 31 30 26 26 24 22 22 21 21 21 21 21 21 21 21 21 21 21 21 21 21 21 21 21 21 21 21 21 21 21 21 21 21 21 21 21 21 21 21 21 21 21 21 21 21 21 
21 25 25 22 21 21 21 21 21 20 20 20 20 20 20 20 20 20 20 20 20 20 20 21 21 21 21 21 21 21 22 22 23 24 26 26 28 29 29 29 28 28 26 23 21 21 21 21 21 22 22 22 22 23 23 23 23 23 23 23 23 23 24 25 25 27 29 31 31 32 33 33 32 32 32 31 29 25 25 23 21 21 21 21 21 21 21 21 21 21 21 21 21 21 21 21 21 21 21 21 21 21 21 21 21 21 21 21 21 21 21 21 21 21 21 21 21 21 21 21 
21 28 27 27 23 22 22 21 21 21 20 20 20 20 20 20 20 20 20 20 20 20 20 21 21 21 21 22 22 22 22 23 23 24 27 27 28 29 29 29 28 25 25 23 22 22 21 21 22 22 22 23 23 23 23 23 24 24 24 24 24 24 24 25 27 27 29 31 31 32 33 33 33 32 31 31 28 25 25 23 21 21 21 21 21 21 21 21 21 21 21 21 21 21 22 22 22 22 22 22 22 22 22 21 21 21 21 21 21 21 21 21 21 21 21 21 21 21 21 21 
21 23 25 25 22 21 21 21 21 20 20 20 20 20 20 20 20 20 20 20 20 20 21 21 21 21 21 21 22 22 22 22 25 25 27 28 28 29 29 29 28 26 23 23 22 22 22 22 22 22 23 23 23 24 24 25 25 25 25 25 25 25 25 25 27 29 29 30 32 32 33 33 33 32 31 29 29 26 23 23 22 21 21 21 21 21 21 21 21 21 21 21 21 21 21 21 22 22 22 22 22 22 22 22 21 21 21 21 21 21 21 21 21 21 21 21 21 21 21 21 
21 21 23 21 21 21 21 21 21 20 20 20 20 20 20 20 20 20 20 20 20 20 20 20 21 21 21 21 21 22 22 23 24 24 27 28 29 29 29 28 28 27 24 24 22 22 22 23 23 24 24 24 25 25 26 26 26 26 26 25 25 25 26 26 26 28 28 29 31 32 32 32 32 32 32 30 30 27 25 23 23 22 22 22 21 21 21 21 21 21 21 21 21 21 22 22 22 22 22 22 22 22 22 22 22 21 21 21 21 21 21 21 21 21 21 21 21 21 21 21 
21 21 25 21 21 21 21 21 21 21 20 20 20 20 20 20 20 20 20 20 20 20 20 20 20 21 21 21 21 21 22 22 23 25 25 28 29 29 29 29 27 27 25 24 24 24 24 24 24 25 25 26 26 27 27 27 27 27 26 25 25 25 26 27 27 28 29 29 30 31 31 32 32 31 31 30 28 28 26 25 25 24 23 22 22 22 21 21 21 21 21 21 22 22 22 22 22 22 22 22 22 22 22 22 21 21 21 21 21 21 21 21 21 21 21 21 21 21 21 21 
21 27 27 22 21 21 21 21 21 21 20 20 20 20 20 20 20 20 20 20 20 20 20 20 20 20 20 21 21 21 21 21 22 24 27 27 28 29 29 29 28 28 26 25 24 24 24 25 25 25 26 26 26 26 27 27 27 26 26 25 25 25 26 26 27 27 28 29 29 30 31 31 31 32 32 31 29 27 27 26 24 24 24 23 23 22 22 21 21 21 21 21 21 22 22 22 22 22 22 22 22 22 22 22 22 21 21 21 21 21 21 21 21 21 21 21 21 21 21 21 
21 28 26 26 22 21 21 21 21 21 21 20 20 20 20 20 20 20 20 20 20 20 20 20 20 20 20 20 21 21 21 22 22 24 26 26 27 28 28 28 28 27 27 25 25 25 25 25 26 26 26 26 26 26 27 27 26 26 25 25 24 25 25 27 28 28 29 29 30 30 30 30 30 31 31 31 29 28 26 26 26 25 25 25 24 24 23 23 23 22 22 21 21 22 22 22 22 22 22 22 22 22 22 22 22 22 21 21 21 21 21 21 21 21 21 21 21 21 21 21 
21 25 25 22 22 21 21 21 21 21 21 20 20 20 20 20 20 20 20 20 20 20 20 20 20 20 20 20 20 20 20 21 22 22 24 25 25 26 26 26 26 26 26 26 26 25 25 26 26 26 26 26 26 26 26 26 26 25 25 24 24 25 26 26 27 29 29 30 30 30 30 30 30 30 30 30 30 28 27 27 26 26 26 26 26 25 25 24 23 23 22 22 22 22 22 22 22 22 22 22 22 22 22 22 22 21 21 21 21 21 21 21 21 21 21 21 21 21 21 21 
21 21 25 20 20 21 21 21 21 21 20 20 20 20 20 20 20 20 20 20 20 20 20 20 20 20 20 20 20 20 21 21 21 23 23 24 24 24 25 25 25 26 26 26 26 26 26 26 26 26 26 26 26 26 26 26 26 26 25 24 24 25 26 27 27 28 30 30 30 30 30 30 30 30 30 30 29 29 27 26 26 26 26 26 26 26 25 25 23 23 23 22 22 22 22 22 22 22 22 22 22 22 22 22 22 21 21 21 21 21 21 21 21 21 21 21 21 21 21 21 
21 27 27 21 21 21 21 21 21 21 20 20 20 20 20 20 20 20 20 20 20 20 20 20 20 20 20 20 20 20 20 20 21 22 23 23 24 24 24 25 25 25 26 26 26 26 26 26 26 26 26 26 26 26 26 26 26 26 26 26 26 26 26 27 27 28 29 30 30 30 29 29 29 30 30 30 30 28 28 27 26 26 25 26 26 26 25 25 25 24 23 23 22 22 22 22 22 22 22 22 22 22 21 21 21 21 21 21 21 21 21 21 21 21 21 21 21 21 20 21 
21 28 23 23 21 21 21 21 21 21 20 20 20 20 20 20 20 20 20 20 20 20 20 20 20 20 20 20 20 20 20 21 21 22 23 23 24 24 25 25 25 25 25 26 26 26 26 26 25 25 25 26 26 26 26 26 26 26 27 27 27 27 27 27 28 28 29 29 29 29 29 29 29 29 29 29 29 28 28 27 26 25 25 25 26 26 26 25 25 25 24 23 23 22 22 22 22 22 22 21 22 22 22 21 21 21 21 21 21 21 21 21 21 21 21 21 21 21 21 20 
20 26 25 25 22 21 21 21 21 20 20 20 20 20 20 20 20 20 20 20 20 20 20 20 20 20 20 20 21 21 21 22 23 23 23 24 24 24 25 25 25 26 26 26 26 26 26 26 25 25 25 25 26 26 26 26 26 27 27 27 27 27 28 28 28 28 28 29 29 29 29 29 29 29 29 29 29 29 27 27 26 26 26 26 25 26 26 25 25 25 25 24 24 23 22 22 22 22 21 21 21 21 21 21 21 21 21 21 21 21 21 21 21 21 21 21 21 21 21 21 
22 22 25 21 21 21 21 21 21 21 20 20 20 20 20 20 20 20 20 20 21 21 20 20 20 20 20 20 21 21 21 22 22 23 23 24 24 24 24 25 25 25 26 26 26 26 25 25 25 25 25 25 25 25 26 26 26 26 27 27 27 27 27 27 28 28 29 29 29 29 29 28 28 28 29 29 28 28 27 26 26 26 25 25 25 26 26 26 26 25 25 24 24 24 23 22 22 21 21 21 21 21 21 21 21 21 21 21 21 21 21 21 21 21 21 21 21 21 20 20 
21 26 26 21 21 21 21 21 21 20 20 20 20 20 20 20 20 20 20 20 20 20 20 20 20 20 20 20 20 20 21 21 22 22 22 23 24 24 24 25 25 25 26 26 26 26 25 25 25 25 25 25 25 25 25 26 26 27 27 27 27 27 27 27 27 28 28 28 28 28 28 28 28 29 29 29 28 28 27 27 26 26 26 26 26 26 26 26 26 26 25 25 24 23 23 22 22 22 21 21 21 21 21 21 21 21 21 21 21 21 21 21 21 21 21 21 21 21 20 20 
20 27 27 22 21 21 21 21 21 21 20 20 20 20 20 20 20 20 20 20 20 20 20 20 20 20 20 20 20 20 21 21 21 22 23 23 24 24 24 25 25 26 26 26 25 25 25 25 25 25 25 25 25 26 26 26 26 26 26 27 27 27 27 27 28 28 28 29 29 29 28 28 28 28 29 29 29 28 28 27 26 26 26 26 26 26 25 26 26 26 25 24 24 24 23 23 22 21 21 21 21 21 21 21 21 21 21 21 21 21 21 21 20 21 21 20 20 20 20 20 
20 26 25 25 22 21 21 21 21 20 20 20 20 20 20 20 20 20 20 20 20 20 20 20 20 20 20 20 20 20 20 20 21 21 22 23 23 24 25 25 25 26 25 25 25 25 25 24 24 24 24 25 25 25 25 26 26 26 26 26 26 26 26 26 27 28 28 29 29 29 28 28 28 28 29 29 29 28 27 27 26 26 26 26 26 25 25 25 25 25 25 25 25 24 23 22 22 21 21 21 21 21 21 20 21 21 20 20 20 20 20 20 20 21 20 20 20 20 20 20 
23 23 24 21 21 21 21 21 20 20 20 20 20 20 20 19 20 20 20 20 20 20 20 20 20 20 20 20 20 20 20 20 21 21 22 23 24 24 25 25 25 25 25 25 25 25 24 24 24 24 24 24 25 25 25 25 25 25 25 25 25 26 26 26 27 28 29 29 29 29 29 28 28 28 29 29 28 28 27 26 26 26 25 25 25 25 25 25 25 25 25 25 25 25 24 23 23 21 21 20 20 20 20 20 20 20 20 20 20 20 20 20 20 20 20 20 20 20 20 20 
21 25 25 21 21 21 21 20 20 20 20 20 20 20 20 20 20 19 19 20 20 20 20 20 20 20 20 20 20 20 20 20 20 22 22 23 24 25 25 25 25 25 25 25 25 24 24 24 24 24 25 25 25 25 25 25 25 25 25 25 25 25 26 27 27 28 29 29 29 28 28 28 28 28 28 29 28 28 27 26 25 25 25 25 25 25 25 25 25 25 25 25 25 23 23 22 21 21 21 20 20 20 20 20 20 20 20 20 20 20 20 20 20 20 20 20 20 20 20 20 
20 27 27 21 21 21 21 20 20 20 20 20 20 20 20 20 20 20 20 20 20 20 20 20 20 20 20 20 20 20 20 20 20 21 22 22 23 24 24 25 25 25 25 25 24 24 24 24 24 24 24 24 24 25 25 25 25 25 25 25 25 25 26 26 27 27 28 29 29 29 28 28 28 28 28 28 29 28 28 27 26 26 25 25 25 25 25 25 25 25 25 25 25 25 23 23 23 21 21 21 20 20 20 20 20 20 20 20 20 20 20 20 20 20 20 20 20 20 20 20 
20 25 24 24 21 21 21 21 20 20 20 20 20 20 20 20 20 19 20 20 20 20 20 20 20 20 20 20 20 20 20 20 20 20 21 23 23 23 24 24 24 24 24 24 24 24 24 24 24 24 24 24 24 25 25 25 25 24 24 24 24 25 25 26 27 28 28 29 29 29 28 28 28 28 28 28 28 28 27 27 26 25 25 25 25 25 24 24 25 25 25 25 25 25 24 24 23 22 21 21 20 20 20 20 20 20 20 20 20 20 20 20 20 20 20 20 20 20 20 20 
24 24 24 21 21 21 20 20 20 20 20 20 20 20 20 20 20 20 20 20 20 20 20 20 20 20 20 20 20 20 20 20 20 20 21 22 23 23 24 24 24 24 24 24 24 24 24 24 24 24 24 24 24 24 24 24 24 24 24 24 24 25 25 25 26 28 28 29 29 28 28 28 27 27 27 28 28 28 27 26 26 25 25 25 24 24 24 24 24 24 25 25 25 25 24 23 23 22 21 21 20 20 20 20 20 20 20 20 19 19 20 20 20 20 20 20 20 20 20 20 
22 22 24 20 21 21 20 20 20 20 20 20 20 20 20 20 20 20 20 20 20 20 20 20 20 20 21 21 22 23 24 24 25 25 25 25 25 25 26 27 28 28 29 30 30 29 27 27 26 25 24 24 24 24 24 25 25 25 25 25 25 25 25 26 26 27 28 28 29 29 29 29 28 27 27 27 27 27 27 26 26 26 25 24 24 24 24 24 24 25 25 25 25 25 25 24 23 23 22 21 21 20 20 20 20 20 20 20 20 20 20 20 20 20 20 20 20 20 20 20 
20 26 26 21 21 21 20 20 20 20 20 20 20 20 19 19 20 20 20 20 20 20 20 19 21 21 20 21 21 20 20 20 20 20 21 21 22 24 24 26 27 27 29 29 28 28 27 26 26 25 24 24 24 24 24 24 24 24 24 24 24 24 25 25 26 26 28 29 29 29 29 29 28 27 27 27 27 27 27 26 26 26 25 24 24 24 24 24 24 25 25 25 25 25 25 24 23 22 22 21 20 20 20 20 20 20 20 20 20 20 20 20 20 20 20 20 20 20 20 20 
20 25 26 26 22 21 21 22 23 23 24 24 24 24 24 24 24 23 22 22 21 20 20 20 20 20 20 20 20 20 20 20 20 20 21 22 22 24 25 25 27 28 28 28 28 27 27 26 25 25 25 24 24 24 24 24 24 24 24 24 24 25 25 26 26 26 28 29 29 29 29 28 28 27 27 27 27 27 27 27 26 25 25 25 24 24 24 24 25 25 25 26 26 25 25 25 23 22 21 21 21 20 20 20 20 20 20 20 20 20 20 20 20 20 20 20 20 20 20 20 
20 24 24 23 23 21 22 22 22 23 23 24 24 24 24 23 22 22 21 20 20 20 20 20 20 20 20 20 20 20 20 20 20 20 20 21 21 22 22 23 23 24 24 24 24 24 24 24 24 24 24 24 24 24 24 24 24 24 24 24 24 25 26 26 27 28 28 28 28 28 28 28 27 27 27 27 27 27 27 27 26 26 25 25 24 24 24 24 25 25 25 25 25 25 25 24 24 23 22 22 21 20 20 20 20 20 20 20 20 20 20 20 20 20 20 20 20 20 20 20 
23 23 24 23 23 21 21 22 22 23 23 23 24 24 24 23 22 21 21 20 20 20 20 20 20 20 20 20 20 20 20 20 20 20 20 20 21 21 21 22 22 22 23 23 23 23 23 23 23 24 24 24 24 24 24 24 24 24 24 25 25 26 26 27 27 28 28 28 28 28 28 27 27 27 27 27 27 27 27 27 27 26 25 25 25 25 24 24 25 25 25 25 25 25 25 24 23 23 22 21 21 21 20 20 20 20 20 20 20 20 20 20 20 20 20 20 20 20 20 20 
20 26 26 21 21 21 22 22 22 23 23 23 23 23 22 22 21 20 20 20 20 20 20 20 20 20 19 19 19 19 20 20 20 20 20 20 20 20 20 20 21 21 22 22 22 23 23 23 23 24 24 24 24 24 24 24 24 24 24 25 26 26 27 27 27 28 28 28 28 28 27 27 27 26 26 26 27 27 27 27 27 27 26 26 26 25 25 25 25 25 25 25 25 25 25 25 24 24 23 22 22 21 21 20 20 20 20 20 20 20 20 20 20 20 20 20 20 20 20 20 
20 26 26 21 21 21 21 21 21 21 21 21 21 21 21 21 21 20 20 20 20 20 20 20 19 19 19 19 20 20 20 20 20 20 20 20 20 20 20 20 21 21 21 22 23 23 23 23 23 24 24 24 24 24 24 24 24 24 24 25 25 25 26 27 27 27 28 28 28 27 27 27 27 26 26 26 27 27 27 27 27 27 26 26 25 25 25 25 25 25 25 25 25 25 25 25 24 23 23 22 22 22 21 20 20 20 20 20 20 20 20 20 20 20 20 20 20 20 20 20 
20 26 22 22 21 21 21 21 21 21 21 21 21 21 21 21 21 20 20 20 20 20 20 20 19 19 19 20 20 20 20 20 19 19 20 20 20 20 20 20 20 21 21 22 23 23 23 23 24 24 24 24 24 24 24 24 24 25 25 25 26 26 26 27 27 27 28 28 27 27 27 27 27 26 26 26 27 27 27 27 28 27 27 27 26 26 25 25 25 25 25 25 25 25 25 25 24 24 23 23 22 21 21 21 20 20 20 20 20 20 20 20 20 20 20 20 20 20 20 20 
20 25 23 20 20 20 20 20 20 20 20 19 19 19 19 19 19 19 19 19 19 19 19 19 19 19 19 19 19 19 19 19 20 20 20 20 20 20 21 22 22 23 23 23 23 23 23 24 24 24 24 24 24 24 24 24 24 24 25 26 26 27 28 28 27 27 27 27 27 27 27 27 27 27 27 27 27 28 28 28 28 28 27 27 27 26 26 25 25 25 25 25 25 25 26 26 26 26 25 25 24 23 22 22 21 20 20 20 20 20 20 19 19 19 19 20 20 20 20 20 
23 23 27 22 22 20 20 20 20 20 20 20 20 20 20 20 20 20 20 20 20 20 21 21 21 22 22 22 22 22 23 23 23 23 23 23 24 24 24 24 24 24 24 24 24 24 24 24 24 24 24 24 25 25 25 26 27 27 28 28 28 28 28 27 27 27 27 27 27 27 27 27 28 28 28 28 29 29 29 29 29 28 28 28 27 26 26 26 25 25 25 25 25 25 26 26 26 26 26 24 24 23 22 22 21 20 20 20 19 20 20 20 19 19 19 19 19 19 20 20 
20 26 26 23 21 21 20 20 20 20 20 20 20 20 20 20 20 20 20 20 21 21 21 21 22 22 22 22 22 22 23 23 23 23 23 23 23 23 23 23 24 24 24 24 24 24 24 24 24 24 24 24 25 25 25 25 26 27 27 27 27 27 27 27 27 27 27 27 27 27 27 27 28 28 28 28 28 28 28 28 27 27 27 27 27 26 26 25 25 25 25 25 25 26 26 26 26 26 26 25 24 24 23 22 22 21 20 20 20 20 19 19 19 19 19 19 19 19 20 20 
19 25 23 23 20 20 20 20 20 20 19 20 20 20 20 19 19 20 19 19 20 20 20 20 20 20 20 21 21 21 22 22 22 22 22 22 22 22 23 23 23 23 23 23 23 23 23 23 23 23 23 23 23 24 24 24 24 24 24 24 25 25 25 25 26 26 26 26 26 26 26 27 27 27 27 27 27 27 27 27 27 27 27 27 26 26 26 26 26 25 25 25 25 25 26 26 26 26 26 26 25 25 24 23 21 21 20 20 20 19 19 19 19 19 19 19 19 20 20 19 
19 25 23 23 20 20 20 20 19 19 19 19 19 19 19 20 20 19 20 19 19 20 20 20 20 20 20 21 21 21 21 22 22 22 22 22 22 22 23 23 23 23 23 23 23 23 23 23 23 23 23 23 23 23 24 24 24 24 24 24 25 25 25 26 26 26 26 26 26 26 26 26 26 26 26 26 26 26 26 26 26 26 26 26 26 26 26 26 25 25 25 25 25 25 25 25 25 26 26 26 26 26 26 26 25 25 23 22 21 21 20 20 20 20 19 19 19 19 19 20 
24 24 23 20 20 20 20 20 19 19 19 19 19 19 19 19 19 19 19 19 19 19 19 20 20 20 20 20 21 21 21 21 22 22 22 22 22 22 22 22 22 22 22 22 23 23 23 23 23 23 23 23 23 23 23 23 23 23 24 24 24 24 25 25 25 25 25 25 26 26 26 26 26 26 26 26 26 26 26 26 26 26 26 26 26 26 26 26 25 25 25 25 25 25 25 25 25 26 26 26 26 26 26 26 25 24 24 23 22 22 21 20 20 20 19 19 19 19 19 19 
25 25 24 20 20 20 20 19 19 19 19 19 19 19 19 19 19 19 19 19 19 19 19 20 20 20 20 20 21 21 22 22 22 22 22 22 22 22 22 22 22 23 23 23 23 23 23 23 23 23 23 23 24 24 24 24 24 24 24 24 24 25 25 25 25 25 25 25 25 25 25 25 25 25 25 25 25 25 25 25 25 25 25 25 25 25 25 25 25 25 25 25 25 25 25 25 26 26 26 26 26 25 25 25 24 22 22 21 20 20 20 20 19 19 20 19 19 19 20 20 
23 25 25 21 20 20 20 19 19 19 19 19 19 19 19 19 19 19 19 19 19 19 19 20 20 20 20 21 21 21 21 21 22 22 22 22 22 22 22 22 23 23 23 23 23 23 23 23 23 23 24 24 24 24 24 24 24 25 25 25 25 25 25 25 25 25 25 25 25 25 25 25 25 25 25 25 25 25 25 25 25 25 25 25 25 25 25 25 25 25 25 25 25 25 25 25 25 25 26 26 25 25 25 24 24 22 21 21 21 20 20 20 20 20 20 20 20 20 19 19 
19 24 22 22 20 20 20 19 19 19 19 19 19 20 20 19 19 19 19 19 19 20 20 20 20 20 20 21 21 21 21 21 21 22 22 22 22 22 22 22 22 22 22 23 23 23 23 23 23 23 23 24 24 24 25 25 25 25 25 25 25 25 25 25 25 25 25 25 25 25 25 25 25 25 25 25 25 25 25 25 25 25 25 25 25 25 25 25 25 25 25 25 25 25 25 25 25 25 25 25 25 25 25 24 23 23 22 21 21 20 20 20 20 20 20 20 20 19 19 19 
19 24 23 23 20 20 20 19 19 19 19 19 19 19 19 20 20 19 19 20 20 20 20 20 20 20 20 21 21 21 21 22 22 22 22 22 22 22 22 22 22 23 23 23 23 23 23 23 23 23 23 24 24 24 24 25 25 25 25 25 26 26 26 26 26 26 26 26 26 26 26 26 26 26 26 26 26 25 25 25 25 25 25 25 25 25 25 25 25 25 25 25 25 25 25 25 25 25 25 25 25 25 25 24 23 23 22 21 21 21 20 20 20 20 20 20 20 19 19 19 
24 24 24 20 20 20 20 20 19 19 19 19 20 20 20 20 20 20 20 20 20 20 20 20 20 20 20 20 20 20 20 20 20 20 21 22 23 23 23 24 24 25 25 25 25 26 26 26 25 25 25 25 26 26 26 26 26 26 26 26 26 26 26 26 26 26 26 26 26 26 26 26 26 26 26 26 26 26 26 25 25 25 25 25 25 25 25 25 25 25 25 25 25 25 25 25 25 25 25 25 25 25 24 24 23 22 22 21 21 21 20 20 20 20 20 20 20 19 19 19 
24 24 25 21 20 20 20 20 20 20 20 20 19 20 20 20 20 20 20 20 20 20 20 21 21 21 21 21 21 21 21 21 22 22 22 23 24 24 24 24 25 25 25 25 25 25 25 25 25 25 25 25 25 25 25 26 26 26 26 26 26 26 26 26 26 26 26 26 26 26 26 26 26 26 26 26 26 26 26 25 25 25 25 25 25 25 25 25 25 25 25 25 25 25 25 25 25 25 25 25 25 25 24 24 24 23 22 22 22 21 21 20 20 20 20 20 20 20 19 19 
20 25 25 23 20 20 20 20 19 19 20 20 20 20 20 20 20 20 20 20 20 20 20 21 21 21 21 22 22 22 22 23 23 23 23 23 24 24 24 24 25 25 25 25 25 25 25 25 25 25 25 25 25 26 26 26 26 26 26 26 26 26 26 26 26 26 26 26 26 26 26 26 26 26 26 26 26 26 26 25 25 25 25 25 25 25 25 25 25 25 25 25 25 25 25 25 25 25 25 25 25 25 25 24 24 23 23 22 22 21 20 20 20 20 20 20 20 19 19 20 
20 25 25 25 21 20 20 20 20 20 20 20 20 20 19 19 19 20 20 20 20 20 20 20 20 20 20 20 21 21 21 22 22 22 23 24 24 24 25 25 26 26 26 26 26 26 26 26 26 26 26 26 26 26 26 26 26 26 26 26 25 26 26 26 26 26 26 26 26 26 26 26 26 26 26 26 26 26 25 25 25 25 25 25 25 25 25 25 25 25 25 25 25 25 25 25 25 25 25 25 25 24 24 24 24 24 23 22 22 22 21 20 20 20 20 20 20 19 19 20 
24 24 26 21 21 20 20 20 20 20 20 20 19 20 20 20 20 20 20 20 20 20 20 20 20 21 21 21 22 23 23 23 24 24 24 25 25 25 25 26 26 26 26 26 26 26 26 26 26 26 26 26 26 26 26 26 26 26 25 25 25 25 25 25 25 26 26 26 26 26 26 26 26 26 26 26 26 26 25 25 25 25 25 25 25 25 25 25 25 25 25 25 25 25 25 25 25 25 25 25 25 25 24 24 24 23 23 23 22 21 21 21 20 20 20 20 20 20 20 20 
24 25 25 21 20 20 20 20 20 20 20 20 20 20 20 20 20 20 20 20 20 20 20 21 21 21 22 23 23 24 24 24 25 25 25 26 26 26 26 26 27 27 27 27 27 27 27 27 27 27 27 27 26 26 26 26 26 26 26 26 26 26 25 25 25 25 25 25 25 25 25 25 25 25 25 25 25 25 25 25 25 25 25 25 25 25 25 25 25 25 25 25 26 26 26 26 26 26 26 26 26 26 26 25 25 24 24 24 23 23 22 22 21 21 21 21 21 21 20 20 
